N N N N N N N N N N N N N N N N N N N N
3 3 3 3 3 3 3 3 3 3 3 3 3 3 3 3 3 3 3 3
3 2 2 2 2 2 2 2 2 2 2 2 0 2 1 2 2 2 2 3 
3 1 1 1 1 R 1 1 1 1 1 1 1 1 4 1 2 1 1 3
3 1 0 0 4 1 1 1 1 E E E E E 1 1 2 8 1 3 
3 1 1 1 1 1 1 1 1 1 1 1 1 1 1 1 2 2 2 3
3 1 1 1 1 1 1 1 1 1 1 1 1 1 1 1 1 1 1 3 
3 1 5 5 5 5 5 5 5 5 5 5 5 5 5 5 5 5 5 3 
3 1 0 E 2 7 2 E E E E E E E E E E E 3 3 
3 3 3 3 3 3 3 3 3 3 3 3 3 3 3 3 3 3 3 3 