3 3 3 3 3 3 3 3 3 3 3 3 3 3 3 3 3 3 3 3
3 1 1 1 1 1 1 0 1 1 R 1 2 E E 1 1 2 1 3
3 1 1 1 0 1 1 1 1 1 1 1 0 1 E 1 1 1 1 3 
3 1 1 1 1 1 1 1 1 1 1 1 0 1 E 1 1 1 1 3
3 2 0 0 4 1 1 1 1 1 1 1 1 1 E E 8 1 1 3 
3 2 1 2 1 1 1 1 1 1 1 1 1 1 E 1 1 1 1 3
3 1 1 1 2 1 1 2 1 1 1 1 1 1 6 1 2 1 2 3 
3 4 4 4 4 4 4 4 4 4 4 4 4 4 4 4 4 4 4 3 
3 1 0 1 1 1 2 1 1 5 1 1 1 1 1 1 1 1 3 3 
3 3 3 3 3 3 3 3 3 3 3 3 3 3 3 3 3 3 3 3 